targetSequences	aaSeqCDR3
GGAGACACCTTTAGCAATCGTGCTATCAACTGGGTGCGTCAGGCCCCTGGACAAGGGCTTGAGTGGATGGGAGGGATCATCCCTATCTATGGGACAACAAACTACGCACAGAAGTTCCAGGACAGAGTCACGATTACCGCGGACAAATTTACGACCACAGCCTACATGGAGTTGAACAGCCTGAGATCTGAGGACACGGCCGTGTACTACTGTGCGAGAATTTGGTTTTCGGAGCCACTATATGGGGGGATTGTCTATTACAACGGTCTGGACGTCTGG	CARIWFSEPLYGGIVYYNGLDVW
GGATACACCTTCACCAGTTATGAAATCAATTGGGTGCGCCAGGCCACTGGACAAGGGCTTGAGTGGATGGGATGGACGAACCCTAAGAGTGGCTACACAGGCTATGCACAGAAGTTCCAGGGCAGAGTCACCATGACGTGGAACACCTCCATCAGCACAGCCTACATGGAACTGCGCAGCCTGACATCTGAGGACACGGCCGTATATTATTGTGCGAGAGAAGTTAGTGACTACAGTGACTACGGAGACGTCTACTACATGGACGTCTGG	CAREVSDYSDYGDVYYMDVW
GGATACACCTTCACCAGTTATGAAATCAATTGGGTGCGCCAGGCCACTGGACAAGGGCTTGAGTGGATGGGATGGACGAACCCTAAGAGTGGCTACACAGGCTATGCACAGAAGTTCCAGGGCAGAGTCACCATGACGTGGAACACCTCCATCAGCACAGCCTACATGGAACTGTGCAGCCTGACATCTGAGGACACGGCCGTATATTATTGTGCGAGAGAAGTTAGTGACTACAGTGACTACGGAGACGTCTACTACATGGACATCTGG	CAREVSDYSDYGDVYYMDIW
GGATTCACCTTCAGTGACTACTACATGAGCTGGATCCGCCAGGCTCCAGGGAAGGGGCTGGAGTGGGTTTCATACATTAGTAGTAGTAGTAGTTACACAAACTACGCAGACTCTGTGAAGGGCCGATTCACCATCTCCAGAGACAACGCCAAGAACTCACTGTATCTGCAAATGAACAGCCTGAGAGCCGAGGACACGGCTATGTATTATTGTGCGAGAGAGGACCGTGGCGAGGACTCATTCGACTACTGG	CAREDRGEDSFDYW
GGTGACTCCCTCAGCAGTGGTTACTCGTGGAGCTGGATCCGGCAGCCACCAGGGAAGGGCCTGGAGTGGATTGGGCACATCTATCATAGTGGGAGCACCTACTACAAACCGTCCCTCAAGAGTCGAGTCACCATATCAGTAGACACGTCCAAGAACCAGTTCTCCCTGAAGCTGAGCTCTGTGACCGCCGCAGACACGGCCGTGTATAACTGTGCAGGACTTACGCAGTCTTCGCATAATGATGCGAATGTG	CAGLTQSSHNDANV
GGTGACTCCCTCAGCAGTGGTTACTCGTGGAGCTGGATCCGGCAGCCACCAGGGAAGGGCCTGGAGTGGATTGGGCACATCTATCATAGTGGGAGCACCTACTACAAACCGTCCCTCAAGAGTCGGGTCACCATATCAGTGGACAGGTCCAGGAACCAGTTCTCCCTGAACTTGAACTCTGCCACCGCCGCAGACACGGCCGTGTATTACTGTGGCGGACTTACGCAGTCTTCGCATAATCTGGGCACGATG	CGGLTQSSHNLGTM
GGTGACTCCCTCAGCAGTGGTTACTCGTGGAGCTGGATCCGGCAGCCACCAGGGAAGGGCCTGGAGTGGATTGGGCACATCTATCATAGTGGGAGCACCTACTACAAACCGTCCCTCAAGAGTCGGGTCACCATATCAGTGGACAGGTCCAGGAACCAGTTCTCCCTGAACTTGAACTCTGTGACCGCCGCGGACACGGCCGTCTATTTCTGTGCAGGACTTACGCAGTCTTCGCATAATGATGCGAATGTG	CAGLTQSSHNDANV
GGTGACTCCCTTAGCAGTGGTTACTCGTGGAGCTGGATCCGGCAGCCACCAGGGAAGGGCCTGGAGTGGATTGGGCACATCTATCATAGTGGGAGCACCTACTACAACCCGTCCCTCAAGAGTCGAGTCACCATATCAGTAGACACGTCCAAGAACCAGTTCTCCCTGAAGCTGAGCTCTGTGACCGCCGCAGACACGGCCGTGTATAACTGTGCAGGACTTACGCAGTCTTCGCATAACGATCCGAATACC	CAGLTQSSHNDPNT
GGTGGCTCCATCAGCAGTAGTAGTTACTACTGGGGCTGGATCCGCCAGCCCCCAGGGAAGGGGCTGGAGTGGATTGGGAGTATCTATTATAGTGGGAGCACCTACTACAACCCGTCCCTCAAGAGTCGAGTCACCATATCCGTAGACACGTCCAAGAACCAGTTCTCCCTGAAGCTGAGCTCTGTGACCGCCGCAGACACGGCTGTGTATAACTGTGCAGGACTTACGCAGTCTTCGCATGACGATCCGAATACC	CAGLTQSSHDDPNT
GGTGGCTCCATCAGCAGTGGTTACGTGTGGGGCTGGAGCCGGCAGCCCCCAGGGAAGGGGGAGGAGCGGATTGGGGCCATCTATCATAGTGGAAGCACCTACTACAACCCGTCCCTCAAGAGTCGAGTCACCATATCAGTAGACACGTCCAAGAACCAGTTCTCCCTGAAGCTGAGCTCTGTGACCGCCGCAGACACGGCCGTGTATAACTGTGCAGGACTTACGCAGTCTTCGCATAATGATCCGAATGTG	CAGLTQSSHNDPNV
GGTGGCTCCATCAGGAGTCACTACTGGAACTGGATCCGGCAGCCCCCAGGGAAGGGGGGCGAGTGGATTGGGAGTATCTATCATAGTGGGAGCACCTACTACAACCCGTCCCTCAAGAGTCGAGTCACCATATCAGTAGACACGTCCAAGAACCAGTTCTCCCTGAAGCTGAGCTCTGTGACCGCCGCAGACACGGCCGTGTATTACTGTGGCGGACTTACGCAGTCTTCGCATAATCTGGGCATGATG	CGGLTQSSHNLGMM
GGTGGCTCCATCAGTAGTTACTACTGGAGCTGGATCCGGCAGCCCCCAGGGAAGGGACTGGAGTGGATTGGGTATATCTATTACAGTGGGAGCACCAACTACAACCCCTCCCTCAAGAGTCGAGTCACCATATCAGTAGACACGTCCAAGAACCAGTTCTCCCTGAAGCTGAGCTCTGTGACCGCCGCAGACACGGCCGTGGATAACTGTGCAGGACTTACGCAGTCTTCGCATAGCGATCCGAATACC	CAGLTQSSHSDPNT
GGTTACTCCATCAGCAGTGGCTACGTGTGGGGCTGGAGCCGGCAGCCCCCAGGGAAGGGGGAGGAGCGGATTGGGGCCATCTATCATAGTGGGAGCACCTACTACAACCCGTCCCTCAAGAGTCGAGTCACCATATCAGTAGACACGTCCAAGAACCAGTTCTCCCTGAAGCTGAGCTCTGTGACCGCCGCAGACACGGCCGTGTATAACTGTGCAGGACTTACGCAGTCTTCGCATAACGATCCGAATACC	CAGLTQSSHNDPNT
GGTTACTCCATCAGCAGTGGTTACGTGTGGGGCTGGAGCCGGCAGCCCCCAGGGAAGGGGGAGGAGCGGATTGGGGCCATCTATCATAGTGGGAGCACCTACTACAACCCGTCCCTCAAGAGTCGAGTCACCATATCAGTAGACACGTCCAAGAACCAGTTCTCCCTGAAGCTGAGCTCTGTGACCGCCGCAGACACGGCCGTGTATAACTGTGCAGGACTTACGCAGCCTTCGCATAATGATCCGAATGTG	CAGLTQPSHNDPNV
GGTTACTCCATCAGCAGTGGTTACGTGTGGGGCTGGAGCCGGCAGCCCCCAGGGAAGGGGGAGGAGCGGATTGGGGCCATCTATCATAGTGGGAGCACCTACTACAACCCGTCCCTCAAGAGTCGAGTCACCATATCAGTAGACACGTCCAAGAACCAGTTCTCCCTGAAGCTGAGCTCTGTGACCGCCGCAGACACGGCCGTGTATAACTGTGCAGGACTTACGCAGTCTTCGCATAATGATCCGAATGTG	CAGLTQSSHNDPNV
GGTTACTCCATCAGCAGTGGTTACGTGTGGGGCTGGAGCCGGCAGCCCCCAGGGAAGGGGGAGGAGCGGATTGGGGCCATCTATCATAGTGGGAGCACCTACTACAACCCGTCCCTCAAGAGTCGAGTCACCATATCAGTAGACACGTCCAAGAACCAGTTCTCCCTGAAGCTGAGCTCTGTGACCGCCGCAGACACGGCCGTGTATAACTGTGCAGGACTTACGCAGTCTTCGCATAATTATCCGAATGTG	CAGLTQSSHNYPNV
GGTTACTCCATCAGCAGTGGTTACGTGTGGGGCTGGAGCCGGCAGCCCCCAGGGAAGGGGGAGGAGCGGATTGGGGCCATCTATCATAGTGGGAGCACCTACTACAACCCGTCCCTCAAGAGTCGAGTCACCATATCAGTAGACACGTCCAAGAACCAGTTCTCCCTGAAGCTGAGCTCTGTGACCGCCGCAGACACGGCCGTGTATTACTGTGCAGGACTTACGCAGTCTTCGCATAATGATCCCAATACC	CAGLTQSSHNDPNT
GGTTACTCCATCAGCAGTGGTTACGTGTGGGGCTGGATCCGGCAGCCCCCAGGGAAGGGGCTGGAGTGGATTGGGGCGATCTATCATAGTGGAGCACCTACTACAACCCGTCCCTCAAGAGTCGAGTCACCATATCAGTAGACACGTCCAAGAACCAGTTCTCCCTGAAGCTGAGCTCTGTGACCGCCGCAGACACGGCCGTGTATAACTGTGCAGGACTTACGCAGTCTTCGCATAACGATCCGAATACC	CAGLTQSSHNDPNT
GGTTACTCCATCAGCAGTGGTTACGTGTGGGGCTGGATCCGGCAGCCCCCAGGGAAGGGGGAGGAGCGGATTGGGAGTATCTATCATAGTGGGAGCACCTACTACAACCCGTCCCTCAAGAGTCGAGTCACCATATCAGTAGACACGTCCAAGAACCAGTTCTCCCTGAAGCTGAGCTCTGTGACCGCCGCAGACACGGCCGTGTATTACTGTGGCGGACTTACGCAGTCTTCGCATAATCTGGGCACGATG	CGGLTQSSHNLGTM
GGTTACTCCATCAGCAGTGGTTACGTGTGGGGCTGGATCCGGCAGCCCCCAGGGAAGGGGGAGGAGCGGATTGGGGCCATCTATCATAGTGGGAGCACCTACTACAACCCGTCCCTCAAAAGTCGAGTCACCATATCAGTAGACACGTCCAAGAACCAGTTCTCCCTGAAGCTGAGCTCTGTGACCGCCGCAGACACGGCCGTGTATAACTGTGCAGGACTTACGCAGTCTTCGCATAATGATGCGAATACC	CAGLTQSSHNDANT
GGTTACTCCATCAGCAGTGGTTACGTGTGGGGCTGGATCCGGCAGCCCCCAGGGAAGGGGGAGGAGCGGATTGGGGCCATCTATCATAGTGGGAGCACCTACTACAACCCGTCCCTCAAGAGTCGAGTCACCATATCAGTAGACACGTCCAAGAACCAGTTCTCCCTGAAGCTGAGCTCTGTGACCGCCGCAGACACGGCCGTGTATAACTGTGCAGGACTTACGCAGTCTTCGCATAATGATGCGAATGTG	CAGLTQSSHNDANV
GGTTACTCCATCAGCAGTGGTTACGTGTGGGGCTGGATCCGGCAGCCCCCAGGGAAGGGGGAGGAGCGGATTGGGGCCATCTATCATAGTGGGAGCACCTACTACAACCCGTCCCTCAAGAGTCGAGTCACCATATCAGTAGACACGTCCAAGAACCAGTTCTCCCTGAAGCTGAGCTCTGTGACCGCCGCAGACACGGCCGTGTATAACTGTGCAGGACTTACGCAGTCTTCGCATGAGGATGCGAATTGG	CAGLTQSSHEDANW
GGTTACTCCATCAGCAGTGGTTACGTGTGGGGCTGGATCCGGCAGCCCCCAGGGAAGGGGGAGGAGCGGATTGGGGCCATCTATCATAGTGGGAGCACCTACTACAACCCGTCCCTCAAGAGTCGAGTCACCATATCAGTAGACACGTCCAAGAACCAGTTCTCCCTGAAGCTGAGCTCTGTGACCGCCGCAGACACGGCCGTGTATTACTGTGCAGGACTTACGCAGTCTTCGCATAATGATCCCAATACC	CAGLTQSSHNDPNT
GGTTACTCCATCAGCAGTGGTTACGTGTGGGGCTGGATCCGGCAGCCCCCAGGGAAGGGGGAGGAGCGGATTGGGGCCATCTATCATAGTGGGAGCACCTACTACAACCCGTCCCTCAAGAGTCGAGTCACCATATCAGTAGACACGTCCAAGAACCAGTTCTCCCTGAAGCTGAGCTCTGTGACCGCCGCAGACACGGCCGTGTATTACTGTGCAGGACTTACGCAGTCTTCGCATGAGGATGCGAATTGG	CAGLTQSSHEDANW
GGTTACTCCATCAGCAGTGGTTACGTGTGGGGCTGGATCCGGCAGCCCCCAGGGAAGGGGGAGGAGCGGATTGGGGCCATCTATCATAGTGGGAGCACCTACTACAACCCGTCCCTCAAGAGTCGAGTCACCATATCAGTAGACACGTCCAAGAACCAGTTCTCCCTGAAGCTGAGCTCTGTGACCGCCGCAGACACGGCCGTGTATTACTGTGGCGGACTTACGCAGTCTTCGCATAATCTGGGCACGATG	CGGLTQSSHNLGTM
GGTTACTCCATCAGCAGTGGTTACTACTGGGGCTGGAGCCGGACCCCCCAGGGAAGGGGCGGAGTGGATTGGGGCGATCTATCATAGTAGGAGCACCTACTACAACCCGTCCCTCAAGAGTCGAGTCACCATATCAGTAGACACGTCCAAGAACCAGTTCTCCCTGAAGCTGAGCTCTGTGACCGCCGCAGACACGGCCGTGTATAACTGTGCAGGACTTACGCAGTCTTCGCATAACGATCCGAATACC	CAGLTQSSHNDPNT
GGTTACTCCATCAGCAGTGGTTACTACTGGGGCTGGAGCCGGACCCCCCAGGGAAGGGGCGGAGTGGATTGGGGCGATCTATCATAGTAGGAGCACCTACTACAACCCGTCCCTCAAGAGTCGAGTCACCATATCAGTAGACACGTCCAAGAACCAGTTCTCCCTGAAGCTGAGCTCTGTGACCGCCGCAGACACGGCCGTGTATTACTGTGCAGGACTTACGCAGTCTTCGCATAATGATCCCAATACC	CAGLTQSSHNDPNT
GGTTACTCCATCAGCAGTGGTTACTACTGGGGCTGGAGCCGGACCCCCCCAGGGAAAGGGGCTGGAGTGGATTGGGGCGATCTATCATAGTGGAGCACCTACTACAACCCGTCCCTCAAGAGTCGAGTCACCATATCAGTAGACACGTCCAAGAACCAGTTCTCCCTGTAGCTGAGCTCTGTGACCGCCGCAGACACGGCCGTGTATAACTGTGCAGGACTTACGCAGTCTTCGCATAACGATCCGAATACT	CAGLTQSSHNDPNT
GGTTACTCCATCAGCAGTGGTTACTACTGGGGCTGGAGCCGGACCCCCCCAGGGAAGGGGCTGGAGCGGATTGGGGCCATCTATCATAGTGGGAGCACCTACTACAACCTGTCCCTCAAGAGTCGAGTCACCATATCAGTAGACACGTCCAAGAACCAGTTCTCCCTGAAGCTGAGCTCTGTGACCGCCGCAGACACGGCCGTGTATAACTGTGCAGGACTTACGCAGTCTTCGCATAATGATGCGAATGTG	CAGLTQSSHNDANV
GGTTACTCCATCAGCAGTGGTTACTACTGGGGCTGGAGCCGGACCCCCCCAGGGAAGGGGCTGGAGTGAATTGGGGCGACCTATCATAGTGGAGCACCTACTACAACCCGTCCCTCAAGAGTCGAGTCACCATATCAGTAGACACGTCCAAGAACCAGTTCTCCCTGAAGCTGAGCTCTGTGACCGCCGCAGACACGGCCGTGTATAACTGTGCAGGGCTTACGCAGTCTTCGCATAACGATCCGAATACC	CAGLTQSSHNDPNT
GGTTACTCCATCAGCAGTGGTTACTACTGGGGCTGGAGCCGGACCCCCCCAGGGAAGGGGCTGGAGTGGATTGGGAGTATCTATCATAGTGGGAGCACCTACTACAACCCGTCCCTCAAGAGTCGAGTCACCATATCAGTAGACACGTCCAAGAACCAGTTCTCCCTGAAGCTGAGCTCTGTGACCGCCGCAGACACGGCCGTGTATTACTGTGCAGGACTTACGCAGTCTTCGCATAATGATGGCAATTGG	CAGLTQSSHNDGNW
GGTTACTCCATCAGCAGTGGTTACTACTGGGGCTGGAGCCGGACCCCCCCAGGGAAGGGGCTGGAGTGGATTGGGGCCATCTATCATAGTGGGAGCACCTACTACAACCCGTCCCTCAAGAGTCGAGTCACCATATCAGTAGACACGTCCAAGAACCAGTTCTCCCTGAAGCTGAGCTCTGTGACCGCCGCAGACACGGCCGTGTATAACTGTGCAGGACTTACGCAGTCTTCGCATAATGATGCGAATGTG	CAGLTQSSHNDANV
GGTTACTCCATCAGCAGTGGTTACTACTGGGGCTGGAGCCGGACCCCCCCAGGGAAGGGGCTGGAGTGGATTGGGGCGATCTAACATAGTGGAGCACCTACTACAACCCGTCCCTCAAGAGTCGAGTCACCATATCAGTAGACACGTCCAAGAACTAGTTCTCCCTGAAGCTGAGCTCTGTGACCGCCGTAGACACGGCCGTGTATAACTGTGCAGGACTTACGCAGTCTTCGCATAACGATCCGAATACC	CAGLTQSSHNDPNT
GGTTACTCCATCAGCAGTGGTTACTACTGGGGCTGGAGCCGGACCCCCCCAGGGAAGGGGCTGGAGTGGATTGGGGCGATCTATCATAGTGGAGCACCTACTACAACCCGTCCCTCAAGAGTCGAGTCACCATATCAGTAGACACGTCCAAGAACCAGTTCTCCCTGAAGCTGAGCTCTGTGACCGCCGCAGACACGGCCGCGTATAACTGTGCAGGACTTACGCAGTCTTCGCATAACGATCCGAATACCGGCCAAAATGGATACCTCCACAGCTGG	CAGLTQSSHNDPNTGQNGYLHSW
GGTTACTCCATCAGCAGTGGTTACTACTGGGGCTGGAGCCGGACCCCCCCAGGGAAGGGGCTGGAGTGGATTGGGGCGATCTATCATAGTGGAGCACCTACTACAACCCGTCCCTCAAGAGTCGAGTCACCATATCAGTAGACACGTCCAAGAACCAGTTCTCCCTGAAGCTGAGCTCTGTGACCGCCGCAGACACGGCCGTGTATAACTGTGCAGGACTTACGCAGTCTTCGCATAACGATCCGAATACC	CAGLTQSSHNDPNT
GGTTACTCCATCAGCAGTGGTTACTACTGGGGCTGGAGCCGGACCCCCCCAGGGAAGGGGCTGGAGTGGATTGGGGCGATCTATCATAGTGGAGCACCTACTACAACCCGTCCCTCAAGAGTCGAGTCACCATATCAGTAGACACGTCCAAGAACCAGTTCTCCCTGAAGCTGAGCTCTGTGACCGCCGCAGACACGGCCGTGTATAACTGTGCAGGACTTACGCAGTCTTCGCATAATCTGGGCACGATG	CAGLTQSSHNLGTM
GGTTACTCCATCAGCAGTGGTTACTACTGGGGCTGGAGCCGGACCCCCCCAGGGAAGGGGCTGGAGTGGATTGGGGCGATCTATCATAGTGGAGCACCTACTACAACCCGTCCCTCAAGAGTCGAGTCACCATATCAGTAGACACGTCCAAGAACCAGTTCTCCCTGAAGCTGAGCTCTGTGACCGCCGCAGACACGGCCGTGTATAACTGTGCAGGACTTACGCAGTCTTCGCATAATGATGCGAATGTG	CAGLTQSSHNDANV
GGTTACTCCATCAGCAGTGGTTACTACTGGGGCTGGAGCCGGACCCCCCCAGGGAAGGGGCTGGAGTGGATTGGGGCGATCTATCATAGTGGAGCACCTACTACAACCCGTCCCTCAAGAGTCGAGTCACCATATCAGTAGACACGTCCAAGAACCAGTTCTCCCTGAAGCTGAGCTCTGTGACCGCCGCAGACACGGCCGTGTATTACTGTGCAGGACTTACGCAGTCTTCGCATAATGATGGCAATTGG	CAGLTQSSHNDGNW
GGTTACTCCATCAGCAGTGGTTACTACTGGGGCTGGAGCCGGACCCCCCCAGGGAAGGGGCTGGAGTGGATTGGGGCGATCTATCATAGTGGAGCACCTACTACAACCCGTCCCTCAAGAGTCGAGTCACCATATCAGTAGACACGTCCAAGAACCAGTTCTCCCTGAAGCTGAGCTCTGTGACCGCCGCAGACACGGCCGTGTATTACTGTGGCGGACTTACGCAGTCTTCGCATAATCTGGGCACGATG	CGGLTQSSHNLGTM
GGTTACTCCATCAGCAGTGGTTACTACTGGGGCTGGAGCCGGACCCCCCCAGGGAAGGGGCTGGAGTGGATTGGGGCGATCTATCATAGTGGAGCACCTACTACAACCCGTCCCTCGAGAGTCGAGTCACCATATCAGTAGACACGTCCAAGAACCAGTTCTCCCTGAAGCTGAGCTCTGTGACAGCCGCAGACACGGCCGTGTATAACTGTGCAGGACTTACGCAGTCTTCGCATAGCGATCCGAATACC	CAGLTQSSHSDPNT
GGTTACTCCATCAGCAGTGGTTACTACTGGGGCTGGAGCCGGACCCCCCCAGGGAAGGGGCTGGAGTGGATTGGGGCGATCTATCATAGTGGGAGCACCTACTACAACCCGTCCCTCAAGAGTCGAGTCACCATATCAGTAGACACGTCCAAGAACCAGTTCTCCCTGAAGCTGAGCTCTGTGACCGCCGCAGACACGGCCGGGTATAACTGTGCAGGACTTACGCAGTCTTCGCATAACGATCCGAATACC	CAGLTQSSHNDPNT
GGTTACTCCATCAGCAGTGGTTACTACTGGGGCTGGAGCCGGACCCCCCCAGGGAAGGGGCTGGAGTGGATTGGGGCGATCTATCATAGTGGGAGCACCTACTACAACCCGTCCCTCAAGAGTCGAGTCACCATATCAGTAGACACGTCCAAGAACCAGTTCTCCCTGAAGCTGAGCTCTGTGACCGCCGCAGACACGGCCGTGTATTACTGTGCAGGACTTACGCAGTCTTCGCATAATGATCCCAATACC	CAGLTQSSHNDPNT
GGTTACTCCATCAGCAGTGGTTACTACTGGGGCTGGAGCCGGACCCCCCCAGGGAAGGGGGAGGAGCGGATTGGGGCCATCTATCATAGTGGGAGCACCTACTACAACCCGTCCCTCAAGAGTCGAGTCACCATATCAGTAGACACGTCCAAGAACCAGTTCTCCCTGAAGCTGAGCTCTGTGACCGCCGCAGACACGGCCGTGTATAACTGTGCAGGACTTACGCAGTCTTCGCATAATGATGCGAATGTG	CAGLTQSSHNDANV
GGTTACTCCATCAGCAGTGGTTACTACTGGGGCTGGAGCCGGACCCCCCCAGGGAAGGGGGGCGAGTGGATTGGGAGTATCTATCATAGTGGGAGCACCTACTACAACCCGTCCCTCAAGAGTCGAGTCACCATATCAGTAGACACGTCCAAGAACCAGTTCTCCCTGAAGCTGAGCTCTGTGACCGCCGCAGACACGGCCGTGTATTACTGTGGCGGACTTACGCAGTCTTCGCATAATCTGGGCACGATG	CGGLTQSSHNLGTM
GGTTACTCCATCAGCAGTGGTTACTACTGGGGCTGGAGCCGGACCCCCCCCAGGGAAGGGGCTGGAGTGGATTGGGGCGATCTACCATAGTGGAGCACCTACTACAACCCGTCCCTCAAGAGTCGAGTCACCATATCAGTAGACACGTCCAAGAACCAGTTCTCCCTGAAGCTGAGCTCTGTGGCCGCCGCAGACACGGCCGTGTATAACTGTGCAGGACTTACGCAGTCTTCGCATAACGATCCGAATACC	CAGLTQSSHNDPNT
GGTTACTCCATCAGCAGTGGTTACTACTGGGGCTGGAGCGGCAGCCCCCAGGGAAGGGGGGCGAGTGGATTGGGAGTATCTATCATAGTGGGAGCACCTACTACAACCCGTCCCTCAAGAGTCGAGTCACCATATCAGTAGACACGTCCAAGAACCAGTTCTCCCTGAAGCTGAGCTCTGTGACCGCCGCAGACACGGCCGTGTATTACTGTGGCGGACTTACGCAGTCTTCGCATGAGGATGCGAATTGG	CGGLTQSSHEDANW
GGTTACTCCATCAGCAGTGGTTACTACTGGGGCTGGATCCGGCAGCCCCCAGGGAAGGGGCTGGAGTGGATTGAGAGTATCTATCATAGTGGGAGCACCTACTACAACCCGTCCCTCAAGAGTCGAGTCACCATATCAGTAGACACGTCCAAGAACCAGTTCTCCCTGAAGCTGAGCTCTGTGACCGCCGCAGACACGGCCGTGTATTACTGTGCAGGACTTACGCAGTCTTCGCATAACGATCCGAATACC	CAGLTQSSHNDPNT
GGTTACTCCATCAGCAGTGGTTACTACTGGGGCTGGATCCGGCAGCCCCCAGGGAAGGGGCTGGAGTGGATTGGGAGTATCTATCATAGTGGAGCACCTACTACAACCCGTCCCTCAAGAGTCGAGTCACCATATCAGTAGACACGTCCAAGAACCAGTTCTCCCTGAAGCTGAGCCCTGTGACCGCCGCAGACACGGCCGTGTATAACTGTGCAGGACTTACGCAGTCTTCGCATAACGATCCGAATACC	CAGLTQSSHNDPNT
GGTTACTCCATCAGCAGTGGTTACTACTGGGGCTGGATCCGGCAGCCCCCAGGGAAGGGGCTGGAGTGGATTGGGAGTATCTATCATAGTGGGAGCACCTACTACAACCCGTCCCTCAAGAGTCGAGTCACCATATCAGAAGACACGTCCAAGGACCAGTTCTCCCTGAAGCTGAGCCCTGTGACCGCCGCAGACACGGCCGTGTATTACTGTGGCGGACTTACGCAGTCTTCGCATAATCTGGGCACGATG	CGGLTQSSHNLGTM
GGTTACTCCATCAGCAGTGGTTACTACTGGGGCTGGATCCGGCAGCCCCCAGGGAAGGGGCTGGAGTGGATTGGGAGTATCTATCATAGTGGGAGCACCTACTACAACCCGTCCCTCAAGAGTCGAGTCACCATATCAGTAGACACGTCCAAGAACCAGTTCTCCCTGAAGCTGAGCTCTGTGACCGCCGCAGACACGGCCGTGTATAACTGTGCAGGACTTACGCAGTCTTCGCATAACGATCCGAATACC	CAGLTQSSHNDPNT
GGTTACTCCATCAGCAGTGGTTACTACTGGGGCTGGATCCGGCAGCCCCCAGGGAAGGGGCTGGAGTGGATTGGGAGTATCTATCATAGTGGGAGCACCTACTACAACCCGTCCCTCAAGAGTCGAGTCACCATATCAGTAGACACGTCCAAGAACCAGTTCTCCCTGAAGCTGAGCTCTGTGACCGCCGCAGACACGGCCGTGTATAACTGTGCAGGACTTACGCAGTCTTCGCATAATGATGCGAATGTG	CAGLTQSSHNDANV
GGTTACTCCATCAGCAGTGGTTACTACTGGGGCTGGATCCGGCAGCCCCCAGGGAAGGGGCTGGAGTGGATTGGGAGTATCTATCATAGTGGGAGCACCTACTACAACCCGTCCCTCAAGAGTCGAGTCACCATATCAGTAGACACGTCCAAGAACCAGTTCTCCCTGAAGCTGAGCTCTGTGACCGCCGCAGACACGGCCGTGTATTACTGTGCAGGACTTACGCAGTCTTCGCATAATCTGGGCACGATG	CAGLTQSSHNLGTM
GGTTACTCCATCAGCAGTGGTTACTACTGGGGCTGGATCCGGCAGCCCCCAGGGAAGGGGCTGGAGTGGATTGGGAGTATCTATCATAGTGGGAGCACCTACTACAACCCGTCCCTCAAGAGTCGAGTCACCATATCAGTAGACACGTCCAAGAACCAGTTCTCCCTGAAGCTGAGCTCTGTGACCGCCGCAGACACGGCCGTGTATTACTGTGCAGGACTTACGCAGTCTTCGCATAATGAT	CAGLTQSSHND
GGTTACTCCATCAGCAGTGGTTACTACTGGGGCTGGATCCGGCAGCCCCCAGGGAAGGGGCTGGAGTGGATTGGGAGTATCTATCATAGTGGGAGCACCTACTACAACCCGTCCCTCAAGAGTCGAGTCACCATATCAGTAGACACGTCCAAGAACCAGTTCTCCCTGAAGCTGAGCTCTGTGACCGCCGCAGACACGGCCGTGTATTACTGTGCAGGACTTACGCAGTCTTCGCATAATGATCCCAATACC	CAGLTQSSHNDPNT
GGTTACTCCATCAGCAGTGGTTACTACTGGGGCTGGATCCGGCAGCCCCCAGGGAAGGGGCTGGAGTGGATTGGGAGTATCTATCATAGTGGGAGCACCTACTACAACCCGTCCCTCAAGAGTCGAGTCACCATATCAGTAGACACGTCCAAGAACCAGTTCTCCCTGAAGCTGAGCTCTGTGACCGCCGCAGACACGGCCGTGTATTACTGTGCAGGACTTACGCAGTCTTCGCATAATGATGCGAATTGG	CAGLTQSSHNDANW
GGTTACTCCATCAGCAGTGGTTACTACTGGGGCTGGATCCGGCAGCCCCCAGGGAAGGGGCTGGAGTGGATTGGGAGTATCTATCATAGTGGGAGCACCTACTACAACCCGTCCCTCAAGAGTCGAGTCACCATATCAGTAGACACGTCCAAGAACCAGTTCTCCCTGAAGCTGAGCTCTGTGACCGCCGCAGACACGGCCGTGTATTACTGTGCAGGACTTACGCAGTCTTCGCATAATGATGGCAATTGG	CAGLTQSSHNDGNW
GGTTACTCCATCAGCAGTGGTTACTACTGGGGCTGGATCCGGCAGCCCCCAGGGAAGGGGCTGGAGTGGATTGGGAGTATCTATCATAGTGGGAGCACCTACTACAACCCGTCCCTCAAGAGTCGAGTCACCATATCAGTAGACACGTCCAAGAACCAGTTCTCCCTGAAGCTGAGCTCTGTGACCGCCGCAGACACGGCCGTGTATTACTGTGCAGGACTTACGCAGTCTTCGCATGAGGATGCGAATTGG	CAGLTQSSHEDANW
GGTTACTCCATCAGCAGTGGTTACTACTGGGGCTGGATCCGGCAGCCCCCAGGGAAGGGGCTGGAGTGGATTGGGAGTATCTATCATAGTGGGAGCACCTACTACAACCCGTCCCTCAAGAGTCGAGTCACCATATCAGTAGACACGTCCAAGAACCAGTTCTCCCTGAAGCTGAGCTCTGTGACCGCCGCAGACACGGCCGTGTATTACTGTGGCGGACTTACGCAGTCTTCGCATAATCTGGGCACGATG	CGGLTQSSHNLGTM
GGTTACTCCATCAGCAGTGGTTACTACTGGGGCTGGATCCGGCAGCCCCCAGGGAAGGGGCTGGAGTGGATTGGGAGTATCTATCATAGTGGGAGCACCTACTACAACCCGTCCCTCAAGAGTCGAGTCACCATATCAGTAGACACGTCCAAGTACCAGTTCTCCCTGAAGCTGAGCTCTGTGACCGCCGCAGACACGGCCGTGTATAACTGTGCAGGACTTACGCAGTCTTCGCATAATGATGCGAATGTG	CAGLTQSSHNDANV
GGTTACTCCATCAGCAGTGGTTACTACTGGGGCTGGATCCGGCAGCCCCCAGGGAAGGGGCTGGAGTGGATTGGGAGTATCTATCATAGTGGGAGCACCTACTACAACCCGTCCCTCAAGAGTCGAGTCACCATATCAGTAGATACGTCCAAGAACCAGTTCTCCCTGAAGCTGAGCTCTGTGACCGCCGCAGACACGGCCGTGTATTACTGTGCAGGACTTACGCAGTCTTCGCATGAAGATGCGAATTGG	CAGLTQSSHEDANW
GGTTACTCCATCAGCAGTGGTTACTACTGGGGCTGGATCCGGCAGCCCCCAGGGAAGGGGCTGGAGTGGATTGGGAGTATCTATCATAGTGGGAGCACCTACTACAGCCCGTCCCTCAAGAGTCGAGTCACCATATCAGTAGACACGTCCAAGAACCAGTTCTCCCTGAAGCTGAGCTCTGTGGCCGCCGCAGACACGGCCGTGTATTACTGTGCAGGACTTACGCAGTCTTCGCATGAGGATGCGAATTGG	CAGLTQSSHEDANW
GGTTACTCCATCAGCAGTGGTTACTACTGGGGCTGGATCCGGCAGCCCCCAGGGAAGGGGCTGGAGTGGATTGGGGCGATCTATCATAGTGGAGCACCTACTACAACCCGTCCCTCAAGAGTCGAGTCACCATATCAGTAGACACGTCCAAGAACCAGTTCTCCCTGAAGCTGAGCTCTGTGACCGCCGCAGACACGGCCGTGTATAACTGTGCAGGACTTACGCAGTCTTCGCATAACGATCCGAATACC	CAGLTQSSHNDPNT
GGTTACTCCATCAGCAGTGGTTACTACTGGGGCTGGATCCGGCAGCCCCCAGGGAAGGGGCTGGAGTGGATTGGGGCGATCTATCATAGTGGAGCACCTACTACAACCCGTCCCTCAAGAGTCGAGTCACCATATCAGTAGACACGTCCAAGAACCAGTTCTCCCTGAAGCTGAGCTCTGTGACCGCCGCAGGCACGGCCGTGTATAACTGTGCAGGACTTACGCAGTCTTCGCATAACGATCCGAATACC	CAGLTQSSHNDPNT
GGTTACTCCATCAGCAGTGGTTACTACTGGGGCTGGATCCGGCAGCCCCCAGGGAAGGGGGGCGAGTGGATTGGGAGTATCTATCATAGTGGGAGCACCTACTACAACCCGTCCCTCAAGAGTCGAGTCACCATATCAGTAGACACGTCCAAGAACCAGTTCTCCCTGAAGCTGAGCTCTGTGACCGCCGCAGACACGGCCGTGTATTACTGTGGCGGACTTACGCAGTCTTCGCATAATCTGGGCACGATG	CGGLTQSSHNLGTM
GGTTACTCCATCAGCAGTGGTTACTACTGGGGCTGGGAGCGGCAGCCCCCAGGGAAGGGGCTGGAGTGGATTGGGGCGATCTATCATAGTGGAGCACCTACTACAACCCGTCCCTCAAGAGTCGAGTCACCATATCAGTAGACACGTCCAAGAACCAGTTCTCCCTGAAGCTGAGCTCTGTGACCGCCGCAGACACGGCCGTGTATAACTGTGCAGGACTTACGCAGTCTTCGCATAACGATCCGAATACC	CAGLTQSSHNDPNT
GGTTACTCCATCAGCAGTGGTTACTACTGGGGCTGGGAGCGGCAGCCCCCAGGGAAGGGGGAGGAGCGGATTGGGGCCATCTATCATAGTGGGAGCACCTACTACAACCCGTCCCTCAAGAGTCGAGTCACCATATCAGTAGACACGTCCAAGAACCAGTTCTCCCTGAAGCTGAGCTCTGTGACCGCCGCAGACACGGCCGTGTATAACTGTGCAGGACTTACGCAGTCTTCGCATAATGATCCGAATGTG	CAGLTQSSHNDPNV
GGTTACTCCATCAGCAGTGGTTACTACTGGGGCTGGGAGCGGCAGCCCCCAGGGAAGGGGGGCGAGTGGATTGGGAGTATCTATCATAGTGGGAGCACCTACTACAACCCGTCCCTCAAGAGTCAAGTCACCATATCAGTAGACACGTCCAAGAGCCAGTTCTCCCTGAAGCTGAGTTCTGTGACCGCCGCAGACACGGCCGTGTATTACTGTGGCGGACTTACGCAGTCTTCGCATAATCTGGGCACGATG	CGGLTQSSHNLGTM
GGTTACTCCATCAGCAGTGGTTACTACTGGGGCTGGGAGCGGCAGCCCCCAGGGAAGGGGGGCGAGTGGATTGGGAGTATCTATCATAGTGGGAGCACCTACTACAACCCGTCCCTCAAGAGTCGAGTCACCATATCAGTAGACACGTCCAAGAACCAGCTCTCCCTGAAGCTGAGCTCTGTGACCGCCGCAGACACGGCCGTGTATTACTGTGGCGGACTTACGCAGTCTTCGCATAATCTGGGCACGATG	CGGLTQSSHNLGTM
GGTTACTCCATCAGCAGTGGTTACTACTGGGGCTGGGAGCGGCAGCCCCCAGGGAAGGGGGGCGAGTGGATTGGGAGTATCTATCATAGTGGGAGCACCTACTACAACCCGTCCCTCAAGAGTCGAGTCACCATATCAGTAGACACGTCCAAGAACCAGTTCTCCCTGAAGCTGAGCTCTGTGACCGCCGCAGACACGGCCGTGTATAACTGTGCAGGACTTACGCAGTCTTCGCATAACGATCCGAATACC	CAGLTQSSHNDPNT
GGTTACTCCATCAGCAGTGGTTACTACTGGGGCTGGGAGCGGCAGCCCCCAGGGAAGGGGGGCGAGTGGATTGGGAGTATCTATCATAGTGGGAGCACCTACTACAACCCGTCCCTCAAGAGTCGAGTCACCATATCAGTAGACACGTCCAAGAACCAGTTCTCCCTGAAGCTGAGCTCTGTGACCGCCGCAGACACGGCCGTGTATAACTGTGCAGGACTTACGCAGTCTTCGCATAATGATCCGAATGTG	CAGLTQSSHNDPNV
GGTTACTCCATCAGCAGTGGTTACTACTGGGGCTGGGAGCGGCAGCCCCCAGGGAAGGGGGGCGAGTGGATTGGGAGTATCTATCATAGTGGGAGCACCTACTACAACCCGTCCCTCAAGAGTCGAGTCACCATATCAGTAGACACGTCCAAGAACCAGTTCTCCCTGAAGCTGAGCTCTGTGACCGCCGCAGACACGGCCGTGTATTACCGTGCAGGACTTACGCAGTCTTCGCATAATGATCCCAATACC	RAGLTQSSHNDPNT
GGTTACTCCATCAGCAGTGGTTACTACTGGGGCTGGGAGCGGCAGCCCCCAGGGAAGGGGGGCGAGTGGATTGGGAGTATCTATCATAGTGGGAGCACCTACTACAACCCGTCCCTCAAGAGTCGAGTCACCATATCAGTAGACACGTCCAAGAACCAGTTCTCCCTGAAGCTGAGCTCTGTGACCGCCGCAGACACGGCCGTGTATTACTGTGCAGGACTTACGCAGTCTTCGCATAATCTGGGCACGATG	CAGLTQSSHNLGTM
GGTTACTCCATCAGCAGTGGTTACTACTGGGGCTGGGAGCGGCAGCCCCCAGGGAAGGGGGGCGAGTGGATTGGGAGTATCTATCATAGTGGGAGCACCTACTACAACCCGTCCCTCAAGAGTCGAGTCACCATATCAGTAGACACGTCCAAGAACCAGTTCTCCCTGAAGCTGAGCTCTGTGACCGCCGCAGACACGGCCGTGTATTACTGTGCAGGACTTACGCAGTCTTCGCATAATGAT	CAGLTQSSHND
GGTTACTCCATCAGCAGTGGTTACTACTGGGGCTGGGAGCGGCAGCCCCCAGGGAAGGGGGGCGAGTGGATTGGGAGTATCTATCATAGTGGGAGCACCTACTACAACCCGTCCCTCAAGAGTCGAGTCACCATATCAGTAGACACGTCCAAGAACCAGTTCTCCCTGAAGCTGAGCTCTGTGACCGCCGCAGACACGGCCGTGTATTACTGTGCAGGACTTACGCAGTCTTCGCATAATGATCCCAATACC	CAGLTQSSHNDPNT
GGTTACTCCATCAGCAGTGGTTACTACTGGGGCTGGGAGCGGCAGCCCCCAGGGAAGGGGGGCGAGTGGATTGGGAGTATCTATCATAGTGGGAGCACCTACTACAACCCGTCCCTCAAGAGTCGAGTCACCATATCAGTAGACACGTCCAAGAACCAGTTCTCCCTGAAGCTGAGCTCTGTGACCGCCGCAGACACGGCCGTGTATTACTGTGCAGGACTTACGCAGTCTTCGCATAATGATGGTAATTGG	CAGLTQSSHNDGNW
GGTTACTCCATCAGCAGTGGTTACTACTGGGGCTGGGAGCGGCAGCCCCCAGGGAAGGGGGGCGAGTGGATTGGGAGTATCTATCATAGTGGGAGCACCTACTACAACCCGTCCCTCAAGAGTCGAGTCACCATATCAGTAGACACGTCCAAGAACCAGTTCTCCCTGAAGCTGAGCTCTGTGACCGCCGCAGACACGGCCGTGTATTACTGTGCAGGACTTACGCAGTCTTCGCATGAGGATGCGAATTGG	CAGLTQSSHEDANW
GGTTACTCCATCAGCAGTGGTTACTACTGGGGCTGGGAGCGGCAGCCCCCAGGGAAGGGGGGCGAGTGGATTGGGAGTATCTATCATAGTGGGAGCACCTACTACAACCCGTCCCTCAAGAGTCGAGTCACCATATCAGTAGACACGTCCAAGAACCAGTTCTCCCTGAAGCTGAGCTCTGTGACCGCCGCAGACACGGCCGTGTATTACTGTGGCGGACTTACGCAGTCTTCGCATAACGATCCGAATACC	CGGLTQSSHNDPNT
GGTTACTCCATCAGCAGTGGTTACTACTGGGGCTGGGAGCGGCAGCCCCCAGGGAAGGGGGGCGAGTGGATTGGGAGTATCTATCATAGTGGGAGCACCTACTACAACCCGTCCCTCAAGAGTCGAGTCACCATATCAGTAGACACGTCCAAGAACCAGTTCTCCCTGAAGCTGAGCTCTGTGACCGCCGCAGACACGGCCGTGTATTACTGTGGCGGACTTACGCAGTCTTCGCATAATCTGGGCACGATG	CGGLTQSSHNLGTM
GGTTACTCCATCAGCAGTGGTTACTACTGGGGCTGGGAGCGGCAGCCCCCAGGGAAGGGGGGCGAGTGGATTGGGAGTATCTATCATAGTGGGAGCACCTACTACAACCCGTCCCTCAAGAGTCGAGTCACCATATCAGTAGACACGTCCAAGAACCAGTTCTCCCTGAAGCTGAGCTCTGTGACCGCCGCAGACACGGCCGTGTATTACTGTGGCGGACTTACGCAGTCTTCGCATAATGATCCCAATACC	CGGLTQSSHNDPNT
GGTTACTCCATCAGCAGTGGTTACTACTGGGGCTGGGAGCGGCAGCCCCCAGGGAAGGGGGGCGAGTGGATTGGGAGTATCTATCATAGTGGGAGCACCTACTACAACCCGTCCCTCAAGAGTCGAGTCACCATATCAGTAGACACGTCCAAGAACCAGTTCTCCCTGAAGCTGAGCTCTGTGACCGCCGCAGACACGGCCGTGTATTACTGTGGCGGACTTACGCAGTCTTCGCATAATGATGCGAATGTG	CGGLTQSSHNDANV
GGTTACTCCATCAGCAGTGGTTACTACTGGGGCTGGGAGCGGCAGCCCCCAGGGAAGGGGGGCGAGTGGATTGGGAGTATCTATCATAGTGGGAGCGCCTACTACAACCCGTCCCTCAAGAGTCGAGTCACCATATCAGTAGACACGTCCAAGAACCAGTTCTCCCTGAAGCTGAGCTCTGTGACCGCCGCAGACACGGCCGTGTATTACTGTGGCGGACTTACGCAGTCTTCGCATAATCTGGGCACGATG	CGGLTQSSHNLGTM
GGTTACTCCATCAGCAGTGGTTACTACTGGGGCTGGGAGCGGCAGCCCCCAGGGAAGGGGGGCGAGTGGATTGGGGCCATCTATCATAGTGGGAGCACCTACTACAACCCGTCCCTCAAGAGTCGAGTCACCATATCAGTAGACACGTCCAAGAACCAGTTCTCCCTGAAGCTGAGCTCTGTGACCGCCGCAGACACGGCCGTGTATAACTGTGCAGGACTTACGCAGTCTTCGCATAATGATCCGAATGTG	CAGLTQSSHNDPNV
GGTTACTCCATCAGCAGTGGTTACTACTGGGGCTGGGAGCGGCAGCCCCCAGGGAAGGGGGGCGAGTGGATTGGGGCGATCTATCATAGTGGAGCACCTACTACAACCCGTCCCTCAAGAGTCGAGTCACCATATCAGTAGACACGTCCAAGAACCAGTTCTCCCTGAAGCTGAGCTCTGTGACCGCCGCAGACACGGCCGTGTATAACTGTGCAGGACTTACGCAGTCTTCGCATAACGATCCGAATACC	CAGLTQSSHNDPNT
GGTTACTCCATCAGCAGTGGTTACTATTGGGGCTGGAGCCGGACCCCCCCAGGGAAGGGGCTGGAGTGGATTGGGGCGATCTATCATAGTGGAGCACCTACTACAACCCGTCCCTCGAGAGTCGAGTCACCATATCAGTAGACACGTCCAAGAACCAGTTCTCCCTGAAGCTGAGCTCTGTGACCGCCGCAGACACGGCCGTGTATAGCTGTGCAGGACTTACGCAGTCTTCGCATAACGATCCGAATACC	CAGLTQSSHNDPNT
GGTTACTCCATCAGCTGTGGTTACTACTGGGGCTGGGAGCGGCAGCCCCCAGGGAAGGGGGGCGAGTGGATTGGGAGTATCTATCATAGTGGGAGCACCTACTACAACCCGTCCCTCAAGAGTCGAGTCACCATATCAGTAGACACGTCCAAGAACCAGTTCTCCCTGAAGCTGAGCTCTGTGACCGCCGCAGACACGGCCGTGTATTACTGTGCAGGACTTACGCAGTCTTCGCATGAGGATGCGAATTGG	CAGLTQSSHEDANW
GGTTACTCCATCGGCAGTGGTTACTACTGGGGCTGGGAGCGGCAGCCCCCAGGGAAGGGGAGCGAGTGGATTGGGAGTATCTATCATAGTGGGAGCACCTACTACAACCCGTCCCTCAAGAGTCGAGTCACCATATCAGTGGACACGTCCAAGAACCAGTTCTCCCTGAAGCTGAGCTCTGTGACCGCCGCAGACACGGCCGTGTATTACTGTGGCGGACTTACGCAGTCTTCGCATAATCTGGGCACGATG	CGGLTQSSHNLGTM
GGTTACTCCGTCAGCAGTGGTTACTACTGGGGCTGGATCCGGCAGCCCCCAGGGAAGGGGCTGGAGTGGATTGGGAGTCTCTCTCATAGTGGCTATACCTACTCCAACCCGTCCCTCAAGAGTCGAGTCACCATATCAGTAGACACGTCCAAGAACCAGTTCTCCCTGAAGCTGAGCTCTGTGACCGCCGCAGACACGGCCGTGTATTACTGTGGCGGACTTACGCAGTCTTCGCATAATCTGGGCACGATG	CGGLTQSSHNLGTM
