GGAGACACCTTTAGCAATCGTGCTATCAACTGGGTGCGTCAGGCCCCTGGACAAGGGCTTGAGTGGATGGGAGGGATCATCCCTATCTATGGGACAACAAACTACGCACAGAAGTTCCAGGACAGAGTCACGATTACCGCGGACAAATTTACGACCACAGCCTACATGGAGTTGAACAGCCTGAGATCTGAGGACACGGCCGTGTACTACTGTGCGAGAATTTGGTTTTCGGAGCCACTATATGGGGGGATTGTCTATTACAACGGTCTGGACGTCTGG 	 39857:CARIWFSEPLYGGIVYYNGLDVW:279
GGTTACTCCATCAGCAGTGGTTACTACTGGGGCTGGGAGCGGCAGCCCCCAGGGAAGGGGGGCGAGTGGATTGGGAGTATCTATCATAGTGGGAGCACCTACTACAACCCGTCCCTCAAGAGTCGAGTCACCATATCAGTAGACACGTCCAAGAACCAGTTCTCCCTGAAGCTGAGCTCTGTGACCGCCGCAGACACGGCCGTGTATTACTGTGGCGGACTTACGCAGTCTTCGCATAATCTGGGCACGATG 	 20501:CGGLTQSSHNLGTM:252
GGTTACTCCATCAGCAGTGGTTACGTGTGGGGCTGGATCCGGCAGCCCCCAGGGAAGGGGGAGGAGCGGATTGGGAGTATCTATCATAGTGGGAGCACCTACTACAACCCGTCCCTCAAGAGTCGAGTCACCATATCAGTAGACACGTCCAAGAACCAGTTCTCCCTGAAGCTGAGCTCTGTGACCGCCGCAGACACGGCCGTGTATTACTGTGGCGGACTTACGCAGTCTTCGCATAATCTGGGCACGATG 	 44843:CGGLTQSSHNLGTM:252
GGTTACTCCATCAGCAGTGGTTACTACTGGGGCTGGATCCGGCAGCCCCCAGGGAAGGGGCTGGAGTGGATTGGGAGTATCTATCATAGTGGGAGCACCTACTACAACCCGTCCCTCAAGAGTCGAGTCACCATATCAGTAGACACGTCCAAGAACCAGTTCTCCCTGAAGCTGAGCTCTGTGACCGCCGCAGACACGGCCGTGTATTACTGTGCAGGACTTACGCAGTCTTCGCATAATCTGGGCACGATG 	 41894:CAGLTQSSHNLGTM:252
GGTTACTCCATCAGCAGTGGTTACGTGTGGGGCTGGAGCCGGCAGCCCCCAGGGAAGGGGGAGGAGCGGATTGGGGCCATCTATCATAGTGGGAGCACCTACTACAACCCGTCCCTCAAGAGTCGAGTCACCATATCAGTAGACACGTCCAAGAACCAGTTCTCCCTGAAGCTGAGCTCTGTGACCGCCGCAGACACGGCCGTGTATAACTGTGCAGGACTTACGCAGTCTTCGCATAATGATCCGAATGTG 	 30:CAGLTQSSHNDPNV:252
GGTTACTCCATCAGCAGTGGTTACGTGTGGGGCTGGATCCGGCAGCCCCCAGGGAAGGGGGAGGAGCGGATTGGGGCCATCTATCATAGTGGGAGCACCTACTACAACCCGTCCCTCAAGAGTCGAGTCACCATATCAGTAGACACGTCCAAGAACCAGTTCTCCCTGAAGCTGAGCTCTGTGACCGCCGCAGACACGGCCGTGTATAACTGTGCAGGACTTACGCAGTCTTCGCATGAGGATGCGAATTGG 	 41854:CAGLTQSSHEDANW:252
GGATACACCTTCACCAGTTATGAAATCAATTGGGTGCGCCAGGCCACTGGACAAGGGCTTGAGTGGATGGGATGGACGAACCCTAAGAGTGGCTACACAGGCTATGCACAGAAGTTCCAGGGCAGAGTCACCATGACGTGGAACACCTCCATCAGCACAGCCTACATGGAACTGCGCAGCCTGACATCTGAGGACACGGCCGTATATTATTGTGCGAGAGAAGTTAGTGACTACAGTGACTACGGAGACGTCTACTACATGGACGTCTGG 	 45808:CAREVSDYSDYGDVYYMDVW:270
GGTTACTCCATCAGCAGTGGTTACTACTGGGGCTGGGAGCGGCAGCCCCCAGGGAAGGGGGAGGAGCGGATTGGGGCCATCTATCATAGTGGGAGCACCTACTACAACCCGTCCCTCAAGAGTCGAGTCACCATATCAGTAGACACGTCCAAGAACCAGTTCTCCCTGAAGCTGAGCTCTGTGACCGCCGCAGACACGGCCGTGTATAACTGTGCAGGACTTACGCAGTCTTCGCATAATGATCCGAATGTG 	 41890:CAGLTQSSHNDPNV:252
GGTTACTCCATCAGCAGTGGTTACTACTGGGGCTGGGAGCGGCAGCCCCCAGGGAAAGGGGGCGAGTGGATTGGGAGTATCTATCATAGTGGGAGCACCTACTACAACCCGTCCCTCAAGAGTCGAGTCACCATATCAGTAGACACGTCCAAGAACCAGTTCTCCCTGAAGCTGAGCTCTGTGACCGCCGCAGACACGGCCGTGTATTACTGTGGCGGACTTTCGCAGTCTTCGCATAATCTGGACACGATG 	 44832:CGGLSQSSHNLDTM:252
GGTTACTCCATCAGCAGTGGTTACTACTGGGGCTGGAGCCGGACCCCCCCAGGGAAGGGGCTGGAGTGAATTGGGGCGACCTATCATAGTGGAGCACCTACTACAACCCGTCCCTCAAGAGTCGAGTCACCATATCAGTAGACACGTCCAAGAACCAGTTCTCCCTGAAGCTGAGCTCTGTGACCGCCGCAGACACGGCCGTGTATAACTGTGCAGGGCTTACGCAGTCTTCGCATAACGATCCGAATACC 	 2046:CAGLTQSSHNDPNT:251
GGTTACTCCATCAGCAGTGGTTACTACTGGGGCTGGGAGCGGCAGCCCCCAGGGAAGGGGGGCGAGTGGATTGGGGCCATCTATCATAGTGGGAGCACCTACTACAACCCGTCCCTCAAGAGTCGAGTCACCATATCAGTAGACACGTCCAAGAACCAGTTCTCCCTGAAGCTGAGCTCTGTGACCGCCGCAGACACGGCCGTGTATAACTGTGCAGGACTTACGCAGTCTTCGCATAATGATCCGAATGTG 	 41891:CAGLTQSSHNDPNV:252
GGTTACTCCATCAGCAGTGGTTACTACTGGGGCTGGGAGCGGCAGCCCCCAGGGAAGGGGGGCGAGTGGATTGGGAGTATCTATCATAGTGGGAGCGCCTACTACAACCCGTCCCTCAAGAGTCGAGTCACCATATCAGTAGACACGTCCAAGAACCAGTTCTCCCTGAAGCTGAGCTCTGTGACCGCCGCAGACACGGCCGTGTATTACTGTGGCGGACTTACGCAGTCTTCGCATAATCTGGGCACGATG 	 23210:CGGLTQSSHNLGTM:252
GGTTACTCCATCAGCAGTGGTTACTACTGGGGCTGGAGCCGGACCCCCCCAGGGAAGGGGGGCGAGTGGATTGGGAGTATCTATCATAGTGGGAGCACCTACTACAACCCGTCCCTCAAGAGTCGAGTCACCATATCAGTAGACACGTCCAAGAACCAGTTCTCCCTGAAGCTGAGCTCTGTGACCGCCGCAGACACGGCCGTGTATTACTGTGGCGGACTTACGCAGTCTTCGCATAATCTGGGCACGATG 	 44847:CGGLTQSSHNLGTM:252
GGTTACTCCATCAGCAGTGGTTACGTGTGGGGCTGGATCCGGCAGCCCCCAGGGAAGGGGGAGGAGCGGATTGGGGCCATCTATCATAGTGGGAGCACCTACTACAACCCGTCCCTCAAGAGTCGAGTCACCATATCAGTAGACACGTCCAAGAACCAGTTCTCCCTGAAGCTGAGCTCTGTGACCGCCGCAGACACGGCCGTGTATAACTGTGCAGGACTTACGCAGTCTTCGCATAATGATGCGAATGTG 	 41858:CAGLTQSSHNDANV:252
GGTTACTCCATCAGCAGTGGTTACTACTGGGGCTGGATCCGGCAGCCCCCAGGGAAGGGGCTGGAGTGGATTGGGAGTATCTATCATAGTGGGAGCACCTACTACAACCCGTCCCTCAAGAGTCGAGTCACCATATCAGTAGACACGTCCAAGAACCAGTTCTCCCTGAAGCTGAGCTCTGTGACCGCCGCAGACACGGCCGTGTATTACTGTGCAGGACTTACGCAGTCTTCGCATAATGATGCGAATTGG 	 27:CAGLTQSSHNDANW:252
GGTTACTCCATCAGCAGTGGTTACTACTGGGGCTGGGAGCGGCAGCCCCCAGGGAAGGGGGGCGAGTGGATTGGGAGTATCTATCATAGTGGGAGCACCTACTACAACCCGTCCCTCAAGAGTCGAGTCACCATATCAGTAGACACGTCCAAGAACCAGTTCTCCCTGAAGCTGAGCTCTGTGACCGCCGCAGACACGGCCGTGTATTACTGTGGCGGACTTACGCAGTCTTCGCATAATGATCCCAATACC 	 44836:CGGLTQSSHNDPNT:252
GGTTACTCCATCAGCAGTGGTTACTACTGGGGCTGGAGCCGGACCCCCCCAGGGAAGGGGCTGGAGTGGATTGGGGCGATCTATCATAGTGGGAGCACCTACTACAACCCGTCCCTCAAGAGTCGAGTCACCATATCAGTAGACACGTCCAAGAACCAGTTCTCCCTGAAGCTGAGCTCTGTGACCGCCGCAGACACGGCCGTGTATTACTGTGCAGGACTTACGCAGTCTTCGCATAATGATCCCAATACC 	 41886:CAGLTQSSHNDPNT:252
GGTTACTCCATCAGCAGTGGTTACTACTGGGGCTGGAGCCGGACCCCCCCAGGGAAGGGGCTGGAGTGGATTGGGGCGATCTATCATAGTGGAGCACCTACTACAACCCGTCCCTCAAGAGTCGAGTCACCATATCAGTAGACACGTCCAAGAACCAGTTCTCCCTGAAGCTGAGCTCTGTGACCGCCGCAGACACGGCCGTGTATTACTGTGCAGGACTTACGCAGTCTTCGCATAATGATGGCAATTGG 	 41868:CAGLTQSSHNDGNW:251
GGTTACTCCATCAGCAGTGGTTACGTGTGGGGCTGGATCCGGCAGCCCCCAGGGAAGGGGGAGGAGCGGATTGGGGCCATCTATCATAGTGGGAGCACCTACTACAACCCGTCCCTCAAGAGTCGAGTCACCATATCAGTAGACACGTCCAAGAACCAGTTCTCCCTGAAGCTGAGCTCTGTGACCGCCGCAGACACGGCCGTGTATTACTGTGCAGGACTTACGCAGTCTTCGCATAATGATCCCAATACC 	 41869:CAGLTQSSHNDPNT:252
GGTTACTCCATCAGCAGTGGTTACTACTGGGGCTGGATCCGGCAGCCCCCAGGGAAGGGGCTGGAGTGGATTGGGGCGATCTATCATAGTGGAGCACCTACTACAACCCGTCCCTCAAGAGTCGAGTCACCATATCAGTAGACACGTCCAAGAACCAGTTCTCCCTGAAGCTGAGCTCTGTGACCGCCGCAGGCACGGCCGTGTATAACTGTGCAGGACTTACGCAGTCTTCGCATAACGATCCGAATACC 	 41885:CAGLTQSSHNDPNT:251
GGTTACTCCATCAGCAGTGGTTACGTGTGGGGCTGGAGCCGGCAGCCCCCAGGGAAGGGGGAGGAGCGGATTGGGGCCATCTATCATAGTGGGAGCACCTACTACAACCCGTCCCTCAAGAGTCGAGTCACCATATCAGTAGACACGTCCAAGAACCAGTTCTCCCTGAAGCTGAGCTCTGTGACCGCCGCAGACACGGCCGTGTATAACTGTGCAGGACTTACGCAGCCTTCGCATAATGATCCGAATGTG 	 8606:CAGLTQPSHNDPNV:252
GGTTACTCCATCAGCAGTGGTTACTACTGGGGCTGGATCCGGCAGCCCCCAGGGAAGGGGCTGGAGTGGATTGGGAGTATCTATCATAGTGGGAGCACCTACTACAACCCGTCCCTCAAGAGTCGAGTCACCATATCAGTAGACACGTCCAAGAACCAGTTCTCCCTGAAGCTGAGCTCTGTGACCGCCGCAGACACGGCCGTGTATTACTGTGCAGGACTTACGCAGTCTTCGCATAATGATGGCAATTGG 	 2044:CAGLTQSSHNDGNW:252
GGTTACTCCATCAGCAGTGGTTACTACTGGGGCTGGGAGCGGCAGCCCCCAGGGAAGGGGGGCGAGTGGATTGGGGCGATCTATCATAGTGGAGCACCTACTACAACCCGTCCCTCAAGAGTCGAGTCACCATATCAGTAGACACGTCCAAGAACCAGTTCTCCCTGAAGCTGAGCTCTGTGACCGCCGCAGACACGGCCGTGTATAACTGTGCAGGACTTACGCAGTCTTCGCATAACGATCCGAATACC 	 41887:CAGLTQSSHNDPNT:251
GGTTACTCCATCAGCAGTGGTTACTATTGGGGCTGGAGCCGGACCCCCCCAGGGAAGGGGCTGGAGTGGATTGGGGCGATCTATCATAGTGGAGCACCTACTACAACCCGTCCCTCGAGAGTCGAGTCACCATATCAGTAGACACGTCCAAGAACCAGTTCTCCCTGAAGCTGAGCTCTGTGACCGCCGCAGACACGGCCGTGTATAGCTGTGCAGGACTTACGCAGTCTTCGCATAACGATCCGAATACC 	 41881:CAGLTQSSHNDPNT:251
GGTTACTCCATCAGCAGTGGTTACTACTGAGGCTGGAGCCGGACCCCCCCAGGGAAGGGGCTGGAGTGGATTGGGAGTATCTATCATAGTGGGAGCACCTACTACAACCCGTCCCTCAAGAGTCGAGTCACCATATCAGTAGACACGTCCAAGAACCAGTTCTCCCTGAAGCTGAGCTCTGTGACCGCCGCAGACACGGCCGTGTATTACTGTGGCGGACTTACGCAGTCTCCGCATAATCTGGGCACGATG 	 44833:CGGLTQSPHNLGTM:252
GGATACACCTTCACCAGTTATGAAATCAATTGGGTGCGCCAGGCCACTGGACAAGGGCTTGAGTGGATGGGATGGACGAACCCTAAGAGTGGCTACACAGGCTATGCACAGAAGTTCCAGGGCAGAGTCACCATGACGTGGAACACCTCCATCAGCACAGCCTACATGGAACTGTGCAGCCTGACATCTGAGGACACGGCCGTATATTATTGTGCGAGAGAAGTTAGTGACTACAGTGACTACGGAGACGTCTACTACATGGACATCTGG 	 45807:CAREVSDYSDYGDVYYMDIW:270
GGTTACTCCATCAGCAGTGGTTACTACTGGGGCTGGAGCCGGACCCCCCCAGGGAAGGGGCTGGAGTGGATTGGGGCGATCTAACATAGTGGAGCACCTACTACAACCCGTCCCTCAAGAGTCGAGTCACCATATCAGTAGACACGTCCAAGAACTAGTTCTCCCTGAAGCTGAGCTCTGTGACCGCCGTAGACACGGCCGTGTATAACTGTGCAGGACTTACGCAGTCTTCGCATAACGATCCGAATACC 	 45176:CAGLTQSSHNDPNT:251
GGTTACTCCATCAGCAGTGGTTACTACTGGGGCTGGAGCCGGACCCCCCCAGGGAAGGGGCTGGAGTGGATTGGGGCGATCTATCATAGTGGAGCACCTACTACAACCCGTCCCTCAAGAGTCGAGTCACCATATCAGTAGACACGTCCAAGAACCAGTTCTCCCTGAAGCTGAGCTCTGTGACCGCCGCAGACACGGCCGTGTATAACTGTGCAGGACTTACGCAGTCTTCGCATAATGATGCGAATGTG 	 41861:CAGLTQSSHNDANV:251
GGTTACTCCATCAGCAGTGGTTACTACTGGGGCTGGGAGCGGCAGCCCCCAGGGAAGGGGGGCGAGTGGATTGGGAGTATCTATCATAGTGGGAGCACCTACTACAACCCGTCCCTCAAGAGTCGAGTCACCATATCAGTAGACACGTCCAAGAACCAGCTCTCCCTGAAGCTGAGCTCTGTGACCGCCGCAGACACGGCCGTGTATTACTGTGGCGGACTTACGCAGTCTTCGCATAATCTGGGCACGATG 	 34961:CGGLTQSSHNLGTM:252
GGTTACTCCATCAGCAGTGGTTACTACTGGGGCTGGATCCGGCAGCCCCCAGGGAAGGGGCTGGAGTGGATTGGGAGTATCTATCATAGTGGGAGCACCTACTACAACCCGTCCCTCAAGAGTCGAGTCACCATATCAGTAGACACGTCCAAGAACCAGTTCTCCCTGAAGCTGAGCTCTGTGACCGCCGCAGACACGGCCGTGTATTACTGTGCAGGACTTACGCAGTCTTCGCATAATGATCCCAATACC 	 29:CAGLTQSSHNDPNT:252
GGTTACTCCATCAGCAGTGGTTACTACTGGGGCTGGATCCGGCAGCCCCCAGGGAAGGGGCTGGAGTGGATTGGGAGTATCTATCATAGTGGGAGCACCTACTACAACCCGTCCCTCAAGAGTCGAGTCACCATATCAGTAGACACGTCCAAGAACCAGTTCTCCCTGAAGCTGAGCTCTGTGACCGCCGCAGACACGGCCGTGTATAACTGTGCAGGACTTACGCAGTCTTCGCATAACGATCCGAATACC 	 41877:CAGLTQSSHNDPNT:252
GGTTACTCCATCAGCAGTGGTTACTACTGGGGCTGGGAGCGGCAGCCCCCAGGGAAGGGGGGCGAGTGGATTGGGAGTATCTATCATAGTGGGAGCACCTACTACAACCCGTCCCTCAAGAGTCGAGTCACCATATCAGTAGACACGTCCAAGAACCAGTTCTCCCTGAAGCTGAGCTCTGTGACCGCCGCAGACACGGCCGTGTATAACTGTGCAGGACTTACGCAGTCTTCGCATAACGATCCGAATACC 	 41874:CAGLTQSSHNDPNT:252
GGTTACTCCATCAGCAGTGGTTACTACTGGGGCTGGAGCCGGACCCCCCCAGGGAAGGGGCTGGAGTGGATTGGGGCGATCTATCATAGTGGAGCACCTACTACAACCCGTCCCTCGAGAGTCGAGTCACCATATCAGTAGACACGTCCAAGAACCAGTTCTCCCTGAAGCTGAGCTCTGTGACAGCCGCAGACACGGCCGTGTATAACTGTGCAGGACTTACGCAGTCTTCGCATAGCGATCCGAATACC 	 45177:CAGLTQSSHSDPNT:251
GGTTACTCCATCAGCAGTGGTTACTACTGGGGCTGGGAGCGGCAGCCCCCAGGGAAGGGGGGCGAGTGGATTGGGAGTATCTATCATAGTGGGAGCACCTACTACAACCCGTCCCTCAAGAGTCGAGTCACCATATCAGTAGACACGTCCAAGAACCAGTTCTCCCTGAAGCTGAGCTCTGTGACCGCCGCAGACACGGCCGTGTATTACTGTGCAGGACTTACGCAGTCTTCGCATAATGATGGTAATTGG 	 41866:CAGLTQSSHNDGNW:252
GGTTACTCCATCAGCTGTGGTTACTACTGGGGCTGGGAGCGGCAGCCCCCAGGGAAGGGGGGCGAGTGGATTGGGAGTATCTATCATAGTGGGAGCACCTACTACAACCCGTCCCTCAAGAGTCGAGTCACCATATCAGTAGACACGTCCAAGAACCAGTTCTCCCTGAAGCTGAGCTCTGTGACCGCCGCAGACACGGCCGTGTATTACTGTGCAGGACTTACGCAGTCTTCGCATGAGGATGCGAATTGG 	 41851:CAGLTQSSHEDANW:252
GGTTACTCCATCAGCAGTGGTTACGTGTGGGGCTGGATCCGGCAGCCCCCAGGGAAGGGGGAGGAGCGGATTGGGGCCATCTATCATAGTGGGAGCACCTACTACAACCCGTCCCTCAAAAGTCGAGTCACCATATCAGTAGACACGTCCAAGAACCAGTTCTCCCTGAAGCTGAGCTCTGTGACCGCCGCAGACACGGCCGTGTATAACTGTGCAGGACTTACGCAGTCTTCGCATAATGATGCGAATACC 	 41856:CAGLTQSSHNDANT:252
GGTTACTCCATCAGCAGTGGTTACTACTGGGGCTGGAGCCGGACCCCCCCAGGGAAGGGGCTGGAGTGGATTGGGAGTATCTATCATAGTGGGAGCACCTACTACAACCCGTCCCTCAAGAGTCGAGTCACCATATCAGTAGACACGTCCAAGAACCAGTTCTCCCTGAAGCTGAGCTCTGTGACCGCCGCAGACACGGCCGTGTATTACTGTGCAGGACTTACGCAGTCTTCGCATAATGATGGCAATTGG 	 41867:CAGLTQSSHNDGNW:252
GGTTACTCCATCAGCAGTGGTTACTACTGGGGCTGGATCCGGCAGCCCCCAGGGAAGGGGCTGGAGTGGATTGGGAGTATCTATCATAGTGGAGCACCTACTACAACCCGTCCCTCAAGAGTCGAGTCACCATATCAGTAGACACGTCCAAGAACCAGTTCTCCCTGAAGCTGAGCCCTGTGACCGCCGCAGACACGGCCGTGTATAACTGTGCAGGACTTACGCAGTCTTCGCATAACGATCCGAATACC 	 41880:CAGLTQSSHNDPNT:251
GGTTACTCCATCAGCAGTGGTTACTACTGGGGCTGGAGCCGGACCCCCCCAGGGAAGGGGCTGGAGTGGATTGGGGCGATCTATCATAGTGGGAGCACCTACTACAACCCGTCCCTCAAGAGTCGAGTCACCATATCAGTAGACACGTCCAAGAACCAGTTCTCCCTGAAGCTGAGCTCTGTGACCGCCGCAGACACGGCCGGGTATAACTGTGCAGGACTTACGCAGTCTTCGCATAACGATCCGAATACC 	 28:CAGLTQSSHNDPNT:252
GGTTACTCCATCAGCAGTGGTTACTACTGGGGCTGGAGCCGGACCCCCCCCAGGGAAGGGGCTGGAGTGGATTGGGGCGATCTACCATAGTGGAGCACCTACTACAACCCGTCCCTCAAGAGTCGAGTCACCATATCAGTAGACACGTCCAAGAACCAGTTCTCCCTGAAGCTGAGCTCTGTGGCCGCCGCAGACACGGCCGTGTATAACTGTGCAGGACTTACGCAGTCTTCGCATAACGATCCGAATACC 	 41875:CAGLTQSSHNDPNT:252
GGTTACTCCATCAGCAGTGGTTACTACTGGGGCTGGGAGCGGCAGCCCCCAGGGAAGGGGGGCGAGTGGATTGGGAGTATCTATCATAGTGGGAGCACCTACTACAACCCGTCCCTCAAGAGTCGAGTCACCATATCAGTAGACACGTCCAAGAACCAGTTCTCCCTGAAGCTGAGCTCTGTGACCGCCGCAGACACGGCCGTGTATAACTGTGCAGGACTTACGCAGTCTTCGCATAATGATCCGAATGTG 	 41893:CAGLTQSSHNDPNV:252
GGTTACTCCATCAGCAGTGGTTACTACTGGGGCTGGGAGCGGCAGCCCCCAGGGAAGGGGGGCGAGTGGATTGGGAGTATCTATCATAGTGGGAGCACCTACTACAACCCGTCCCTCAAGAGTCGAGTCACCATATCAGTAGACACGTCCAAGAACCAGTTCTCCCTGAAGCTGAGCTCTGTGACCGCCGCAGACACGGCCGTGTATTACTGTGGCGGACTTACGCAGTCTTCGCATAACGATCCGAATACC 	 44837:CGGLTQSSHNDPNT:252
GGTTACTCCATCAGCAGTGGTTACTACTGGGGCTGGATCCGGCAGCCCCCAGGGAAGGGGCTGGAGTGGATTGGGAGTATCTATCATAGTGGGAGCACCTACTACAACCCGTCCCTCAAGAGTCGAGTCACCATATCAGAAGACACGTCCAAGGACCAGTTCTCCCTGAAGCTGAGCCCTGTGACCGCCGCAGACACGGCCGTGTATTACTGTGGCGGACTTACGCAGTCTTCGCATAATCTGGGCACGATG 	 44840:CGGLTQSSHNLGTM:252
GGTTACTCCATCAGCAGTGGTTACGTGTGGGGCTGGATCCGGCAGCCCCCAGGGAAGGGGGAGGAGCGGATTGGGGCCATCTATCATAGTGGGAGCACCTACTACAACCCGTCCCTCAAGAGTCGAGTCACCATATCAGTAGACACGTCCAAGAACCAGTTCTCCCTGAAGCTGAGCTCTGTGACCGCCGCAGACACGGCCGTGTATTACTGTGGCGGACTTACGCAGTCTTCGCATAATCTGGGCACGATG 	 44842:CGGLTQSSHNLGTM:252
GGTTACTCCATCAGCAGTGGTTACTACTGGGGCTGGATCCGGCAGCCCCCAGGGAAGGGGCTGGAGTGGATTGGGAGTATCTATCATAGTGGGAGCACCTACTACAACCCGTCCCTCAAGAGTCGAGTCACCATATCAGTAGATACGTCCAAGAACCAGTTCTCCCTGAAGCTGAGCTCTGTGACCGCCGCAGACACGGCCGTGTATTACTGTGCAGGACTTACGCAGTCTTCGCATGAAGATGCGAATTGG 	 2043:CAGLTQSSHEDANW:252
GGTTACTCCATCAGCAGTGGTTACGTGTGGGGCTGGATCCGGCAGCCCCCAGGGAAGGGGCTGGAGTGGATTGGGGCGATCTATCATAGTGGAGCACCTACTACAACCCGTCCCTCAAGAGTCGAGTCACCATATCAGTAGACACGTCCAAGAACCAGTTCTCCCTGAAGCTGAGCTCTGTGACCGCCGCAGACACGGCCGTGTATAACTGTGCAGGACTTACGCAGTCTTCGCATAACGATCCGAATACC 	 41872:CAGLTQSSHNDPNT:251
GGTTACTCCATCAGCAGTGGTTACTACTGGGGCTGGGAGCGGCAGCCCCCAGGGAAGGGGGGCGAGTGGATTGGGAGTATCTATCATAGTGGGAGCACCTACTACAACCCGTCCCTCAAGAGTCGAGTCACCATATCAGTAGACACGTCCAAGAACCAGTTCTCCCTGAAGCTGAGCTCTGTGACCGCCGCAGACACGGCCGTGTATTACCGTGCAGGACTTACGCAGTCTTCGCATAATGATCCCAATACC 	 46404:RAGLTQSSHNDPNT:252
GGTTACTCCATCAGCAGTGGTTACTACTGGGGCTGGAGCCGGACCCCCCCAGGGAAAGGGGCTGGAGTGGATTGGGGCGATCTATCATAGTGGAGCACCTACTACAACCCGTCCCTCAAGAGTCGAGTCACCATATCAGTAGACACGTCCAAGAACCAGTTCTCCCTGTAGCTGAGCTCTGTGACCGCCGCAGACACGGCCGTGTATAACTGTGCAGGACTTACGCAGTCTTCGCATAACGATCCGAATACT 	 41876:CAGLTQSSHNDPNT:252
GGTTACTCCATCAGCAGTGGTTACTACTGGGGCTGGGAGCGGCAGCCCCCAGGGAAGGGGGGCGAGTGGATTGGGAGTATCTATCATAGTGGGAGCACCTACTACAACCCGTCCCTCAAGAGTCGAGTCACCATATCAGTAGACACGTCCAAGAACCAGTTCTCCCTGAAGCTGAGCTCTGTGACCGCCGCAGACACGGCCGTGTATTACTGTGCAGGACTTACGCAGTCTTCGCATGAGGATGCGAATTGG 	 41853:CAGLTQSSHEDANW:252
GGTTACTCCATCAGCAGTGGCTACGTGTGGGGCTGGAGCCGGCAGCCCCCAGGGAAGGGGGAGGAGCGGATTGGGGCCATCTATCATAGTGGGAGCACCTACTACAACCCGTCCCTCAAGAGTCGAGTCACCATATCAGTAGACACGTCCAAGAACCAGTTCTCCCTGAAGCTGAGCTCTGTGACCGCCGCAGACACGGCCGTGTATAACTGTGCAGGACTTACGCAGTCTTCGCATAACGATCCGAATACC 	 41884:CAGLTQSSHNDPNT:252
GGATTCACCTTCAGTGACTACTACATGAGCTGGATCCGCCAGGCTCCAGGGAAGGGGCTGGAGTGGGTTTCATACATTAGTAGTAGTAGTAGTTACACAAACTACGCAGACTCTGTGAAGGGCCGATTCACCATCTCCAGAGACAACGCCAAGAACTCACTGTATCTGCAAATGAACAGCCTGAGAGCCGAGGACACGGCTATGTATTATTGTGCGAGAGAGGACCGTGGCGAGGACTCATTCGACTACTGG 	 1005:CAREDRGEDSFDYW:252
GGTTACTCCATCAGCAGTGGTTACTACTGGGGCTGGATCCGGCAGCCCCCAGGGAAGGGGCTGGAGTGGATTGGGGCGATCTATCATAGTGGAGCACCTACTACAACCCGTCCCTCAAGAGTCGAGTCACCATATCAGTAGACACGTCCAAGAACCAGTTCTCCCTGAAGCTGAGCTCTGTGACCGCCGCAGACACGGCCGTGTATAACTGTGCAGGACTTACGCAGTCTTCGCATAACGATCCGAATACC 	 41883:CAGLTQSSHNDPNT:251
GGTTACTCCATCAGCAGTGGTTACTACTGGGGCTGGAGCCGGACCCCCCAGGGAAGGGGCGGAGTGGATTGGGGCGATCTATCATAGTAGGAGCACCTACTACAACCCGTCCCTCAAGAGTCGAGTCACCATATCAGTAGACACGTCCAAGAACCAGTTCTCCCTGAAGCTGAGCTCTGTGACCGCCGCAGACACGGCCGTGTATAACTGTGCAGGACTTACGCAGTCTTCGCATAACGATCCGAATACC 	 41870:CAGLTQSSHNDPNT:250
GGTTACTCCATCAGCAGTGGTTACTACTGGGGCTGGGAGCGGCAGCCCCCAGGGAAGGGGGGCGAGTGGATTGGGAGTATCTATCATAGTGGGAGCACCTACTACAACCCGTCCCTCAAGAGTCGAGTCACCATATCAGTAGACACGTCCAAGAACCAGTTCTCCCTGAAGCTGAGCTCTGTGACCGCCGCAGACACGGCCGTGTATTACTGTGCAGGACTTACGCAGTCTTCGCATAATCTGGGCACGATG 	 31:CAGLTQSSHNLGTM:252
GGTTACTCCATCAGCAGTGGTTACGTGTGGGGCTGGAGCCGGCAGCCCCCAGGGAAGGGGGAGGAGCGGATTGGGGCCATCTATCATAGTGGGAGCACCTACTACAACCCGTCCCTCAAGAGTCGAGTCACCATATCAGTAGACACGTCCAAGAACCAGTTCTCCCTGAAGCTGAGCTCTGTGACCGCCGCAGACACGGCCGTGTATAACTGTGCAGGACTTACGCAGTCTTCGCATAATTATCCGAATGTG 	 32:CAGLTQSSHNYPNV:252
GGTGGCTCCATCAGCAGTGGTTACGTGTGGGGCTGGAGCCGGCAGCCCCCAGGGAAGGGGGAGGAGCGGATTGGGGCCATCTATCATAGTGGAAGCACCTACTACAACCCGTCCCTCAAGAGTCGAGTCACCATATCAGTAGACACGTCCAAGAACCAGTTCTCCCTGAAGCTGAGCTCTGTGACCGCCGCAGACACGGCCGTGTATAACTGTGCAGGACTTACGCAGTCTTCGCATAATGATCCGAATGTG 	 41892:CAGLTQSSHNDPNV:252
GGTTACTCCATCAGCAGTGGTTACTACTGGGGCTGGAGCCGGACCCCCCCAGGGAAGGGGCTGGAGTGGATTGGGGCGATCTATCATAGTGGAGCACCTACTACAACCCGTCCCTCAAGAGTCGAGTCACCATATCAGTAGACACGTCCAAGAACCAGTTCTCCCTGAAGCTGAGCTCTGTGACCGCCGCAGACACGGCCGTGTATAACTGTGCAGGACTTACGCAGTCTTCGCATAATCTGGGCACGATG 	 41895:CAGLTQSSHNLGTM:251
GGTTACTCCATCAGCAGTGGTTACTACTGGGGCTGGAGCCGGACCCCCCCAGGGAAGGGGCTGGAGTGGATTGGGGCCATCTATCATAGTGGGAGCACCTACTACAACCCGTCCCTCAAGAGTCGAGTCACCATATCAGTAGACACGTCCAAGAACCAGTTCTCCCTGAAGCTGAGCTCTGTGACCGCCGCAGACACGGCCGTGTATAACTGTGCAGGACTTACGCAGTCTTCGCATAATGATGCGAATGTG 	 41860:CAGLTQSSHNDANV:252
GGTTACTCCATCAGCAGTGGTTACTACTGGGGCTGGATCCGGCAGCCCCCAGGGAAGGGGCTGGAGTGGATTGGGAGTATCTATCATAGTGGGAGCACCTACTACAACCCGTCCCTCAAGAGTCGAGTCACCATATCAGTAGACACGTCCAAGAACCAGTTCTCCCTGAAGCTGAGCTCTGTGACCGCCGCAGACACGGCCGTGTATTACTGTGCAGGACTTACGCAGTCTTCGCATGAGGATGCGAATTGG 	 2618:CAGLTQSSHEDANW:252
GGTTACTCCATCAGCAGTGGTTACTACTGGGGCTGGATCCGGCAGCCCCCAGGGAAGGGGCTGGAGTGGATTGGGAGTATCTATCATAGTGGGAGCACCTACTACAACCCGTCCCTCAAGAGTCGAGTCACCATATCAGTAGACACGTCCAAGTACCAGTTCTCCCTGAAGCTGAGCTCTGTGACCGCCGCAGACACGGCCGTGTATAACTGTGCAGGACTTACGCAGTCTTCGCATAATGATGCGAATGTG 	 41862:CAGLTQSSHNDANV:252
GGTTACTCCATCAGCAGTGGTTACTACTGGGGCTGGATCCGGCAGCCCCCAGGGAAGGGGCTGGAGTGGATTGGGAGTATCTATCATAGTGGGAGCACCTACTACAACCCGTCCCTCAAGAGTCGAGTCACCATATCAGTAGACACGTCCAAGAACCAGTTCTCCCTGAAGCTGAGCTCTGTGACCGCCGCAGACACGGCCGTGTATAACTGTGCAGGACTTACGCAGTCTTCGCATAATGATGCGAATGTG 	 41864:CAGLTQSSHNDANV:252
GGTTACTCCATCAGCAGTGGTTACTACTGGGGCTGGGAGCGGCAGCCCCCAGGGAAGGGGGGCGAGTGGATTGGGAGTATCTATCATAGTGGGAGCACCTACTACAACCCGTCCCTCAAGAGTCGAGTCACCATATCAGTAGACACGTCCAAGAACCAGTTCTCCCTGAAGCTGAGCTCTGTGACCGCCGCAGACACGGCCGTGTATTACTGTGCAGGACTTACGCAGTCTTCGCATAATGATCCCAATACC 	 41873:CAGLTQSSHNDPNT:252
GGTTACTCCATCAGCAGTGGTTACTACTGGGGCTGGAGCCGGACCCCCCCAGGGAAGGGGCTGGAGTGGATTGGGGCGATCTATCATAGTGGAGCACCTACTACAACCCGTCCCTCAAGAGTCGAGTCACCATATCAGTAGACACGTCCAAGAACCAGTTCTCCCTGAAGCTGAGCTCTGTGACCGCCGCAGACACGGCCGTGTATAACTGTGCAGGACTTACGCAGTCTTCGCATAACGATCCGAATACC 	 2045:CAGLTQSSHNDPNT:251
GGTTACTCCATCAGCAGTGGTTACTACTGGGGCTGGAGCCGGACCCCCCAGGGAAGGGGCGGAGTGGATTGGGGCGATCTATCATAGTAGGAGCACCTACTACAACCCGTCCCTCAAGAGTCGAGTCACCATATCAGTAGACACGTCCAAGAACCAGTTCTCCCTGAAGCTGAGCTCTGTGACCGCCGCAGACACGGCCGTGTATTACTGTGCAGGACTTACGCAGTCTTCGCATAATGATCCCAATACC 	 41879:CAGLTQSSHNDPNT:250
GGTTACTCCATCAGCAGTGGTTACTACTGGGGCTGGATCCGGCAGCCCCCAGGGAAGGGGCTGGAGTGGATTGGGAGTATCTATCATAGTGGGAGCACCTACTACAGCCCGTCCCTCAAGAGTCGAGTCACCATATCAGTAGACACGTCCAAGAACCAGTTCTCCCTGAAGCTGAGCTCTGTGGCCGCCGCAGACACGGCCGTGTATTACTGTGCAGGACTTACGCAGTCTTCGCATGAGGATGCGAATTGG 	 2619:CAGLTQSSHEDANW:252
GGTTACTCCATCAGCAGTGGTTACTACTGGGGCTGGGAGCGGCAGCCCCCAGGGAAGGGGCTGGAGTGGATTGGGGCGATCTATCATAGTGGAGCACCTACTACAACCCGTCCCTCAAGAGTCGAGTCACCATATCAGTAGACACGTCCAAGAACCAGTTCTCCCTGAAGCTGAGCTCTGTGACCGCCGCAGACACGGCCGTGTATAACTGTGCAGGACTTACGCAGTCTTCGCATAACGATCCGAATACC 	 41871:CAGLTQSSHNDPNT:251
GGTTACTCCATCAGCAGTGGTTACTACTGGGGCTGGAGCGGCAGCCCCCAGGGAAGGGGGGCGAGTGGATTGGGAGTATCTATCATAGTGGGAGCACCTACTACAACCCGTCCCTCAAGAGTCGAGTCACCATATCAGTAGACACGTCCAAGAACCAGTTCTCCCTGAAGCTGAGCTCTGTGACCGCCGCAGACACGGCCGTGTATTACTGTGGCGGACTTACGCAGTCTTCGCATGAGGATGCGAATTGG 	 41288:CGGLTQSSHEDANW:251
GGTTACTCCATCAGCAGTGGTTACTACTGGGGCTGGGAGCGGCAGCCCCCAGGGAAGGGGGGCGAGTGGATTGGGAGTATCTATCATAGTGGGAGCACCTACTACAACCCGTCCCTCAAGAGTCGAGTCACCATATCAGTAGACACGTCCAAGAACCAGTTCTCCCTGAAGCTGAGCTCTGTGACCGCCGCAGACACGGCCGTGTATTACTGTGGCGGACTTACGCAGTCTTCGCATAATGATGCGAATGTG 	 44835:CGGLTQSSHNDANV:252
GGTTACTCCATCAGCAGTGGTTACTACTGGGGCTGGAGCCGGACCCCCCCAGGGAAGGGGGAGGAGCGGATTGGGGCCATCTATCATAGTGGGAGCACCTACTACAACCCGTCCCTCAAGAGTCGAGTCACCATATCAGTAGACACGTCCAAGAACCAGTTCTCCCTGAAGCTGAGCTCTGTGACCGCCGCAGACACGGCCGTGTATAACTGTGCAGGACTTACGCAGTCTTCGCATAATGATGCGAATGTG 	 41863:CAGLTQSSHNDANV:252
GGTTACTCCATCAGCAGTGGTTACTACTGGGGCTGGAGCCGGACCCCCCCAGGGAAGGGGCTGGAGTGGATTGGGGCGATCTATCATAGTGGAGCACCTACTACAACCCGTCCCTCAAGAGTCGAGTCACCATATCAGTAGACACGTCCAAGAACCAGTTCTCCCTGAAGCTGAGCTCTGTGACCGCCGCAGACACGGCCGTGTATTACTGTGGCGGACTTACGCAGTCTTCGCATAATCTGGGCACGATG 	 44845:CGGLTQSSHNLGTM:251
GGTTACTCCATCAGCAGTGGTTACTACTGGGGCTGGATCCGGCAGCCCCCAGGGAAGGGGCTGGAGTGGATTGAGAGTATCTATCATAGTGGGAGCACCTACTACAACCCGTCCCTCAAGAGTCGAGTCACCATATCAGTAGACACGTCCAAGAACCAGTTCTCCCTGAAGCTGAGCTCTGTGACCGCCGCAGACACGGCCGTGTATTACTGTGCAGGACTTACGCAGTCTTCGCATAACGATCCGAATACC 	 41888:CAGLTQSSHNDPNT:252
GGTTACTCCATCAGCAGTGGTTACTACTGGGGCTGGATCCGGCAGCCCCCAGGGAAGGGGGGCGAGTGGATTGGGAGTATCTATCATAGTGGGAGCACCTACTACAACCCGTCCCTCAAGAGTCGAGTCACCATATCAGTAGACACGTCCAAGAACCAGTTCTCCCTGAAGCTGAGCTCTGTGACCGCCGCAGACACGGCCGTGTATTACTGTGGCGGACTTACGCAGTCTTCGCATAATCTGGGCACGATG 	 44841:CGGLTQSSHNLGTM:252
GGTTACTCCATCAGCAGTGGTTACGTGTGGGGCTGGATCCGGCAGCCCCCAGGGAAGGGGGAGGAGCGGATTGGGGCCATCTATCATAGTGGGAGCACCTACTACAACCCGTCCCTCAAGAGTCGAGTCACCATATCAGTAGACACGTCCAAGAACCAGTTCTCCCTGAAGCTGAGCTCTGTGACCGCCGCAGACACGGCCGTGTATTACTGTGCAGGACTTACGCAGTCTTCGCATGAGGATGCGAATTGG 	 41852:CAGLTQSSHEDANW:252
GGTTACTCCATCAGCAGTGGTTACTACTGGGGCTGGAGCCGGACCCCCCCAGGGAAGGGGCTGGAGCGGATTGGGGCCATCTATCATAGTGGGAGCACCTACTACAACCTGTCCCTCAAGAGTCGAGTCACCATATCAGTAGACACGTCCAAGAACCAGTTCTCCCTGAAGCTGAGCTCTGTGACCGCCGCAGACACGGCCGTGTATAACTGTGCAGGACTTACGCAGTCTTCGCATAATGATGCGAATGTG 	 41865:CAGLTQSSHNDANV:252
GGTTACTCCATCGGCAGTGGTTACTACTGGGGCTGGGAGCGGCAGCCCCCAGGGAAGGGGAGCGAGTGGATTGGGAGTATCTATCATAGTGGGAGCACCTACTACAACCCGTCCCTCAAGAGTCGAGTCACCATATCAGTGGACACGTCCAAGAACCAGTTCTCCCTGAAGCTGAGCTCTGTGACCGCCGCAGACACGGCCGTGTATTACTGTGGCGGACTTACGCAGTCTTCGCATAATCTGGGCACGATG 	 25856:CGGLTQSSHNLGTM:252
GGTTACTCCATCAGCAGTGGTTACTACTGGGGCTGGATCCGGCAGCCCCCAGGGAAGGGGCTGGAGTGGATTGGGAGTATCTATCATAGTGGGAGCACCTACTACAACCCGTCCCTCAAGAGTCGAGTCACCATATCAGTAGACACGTCCAAGAACCAGTTCTCCCTGAAGCTGAGCTCTGTGACCGCCGCAGACACGGCCGTGTATTACTGTGGCGGACTTACGCAGTCTTCGCATAATCTGGGCACGATG 	 44839:CGGLTQSSHNLGTM:252
GGTTACTCCATCAGCAGTGGTTACTACTGGGGCTGGGAGCGGCAGCCCCCAGGGAAGGGGGGCGAGTGGATTGGGAGTATCTATCATAGTGGGAGCACCTACTACAACCCGTCCCTCAAGAGTCAAGTCACCATATCAGTAGACACGTCCAAGAGCCAGTTCTCCCTGAAGCTGAGTTCTGTGACCGCCGCAGACACGGCCGTGTATTACTGTGGCGGACTTACGCAGTCTTCGCATAATCTGGGCACGATG 	 44846:CGGLTQSSHNLGTM:252
GGTTACTCCATCAGCAGTGGTTACGTGTGGGGCTGGAGCCGGCAGCCCCCAGGGAAGGGGGAGGAGCGGATTGGGGCCATCTATCATAGTGGGAGCACCTACTACAACCCGTCCCTCAAGAGTCGAGTCACCATATCAGTAGACACGTCCAAGAACCAGTTCTCCCTGAAGCTGAGCTCTGTGACCGCCGCAGACACGGCCGTGTATTACTGTGCAGGACTTACGCAGTCTTCGCATAATGATCCCAATACC 	 41882:CAGLTQSSHNDPNT:252
